28 16
############################
#...f.a....................#
#.uauau.......o............#
#.s........................#
#.........................o#
#......s............s......#
#..........................#
#........o.................#
#.................s........#
#..........................#
#......s.................o.#
#....o.....................#
#................s...u.a.a.#
#.@.....o............u.w...#
#....................u.....#
############################
