34 16
###################################
#.................................#
#.................................#
#.................................#
#.................................#
#.................................#
#.................................#
#.................................#
#.................................#
#.................................#
#.................................#
#.................................#
#.................................#
#.@...............................#
#.................................#
###################################